1111111111111111111111111111111111111111111111111111111111111111111111
1000000000000000000000002000000000000000000000000000000000000000000001
1000000000000000000000000000000000000000000000000000000000000000000001
1000000000000000000000000000000000000000000000000000000000000000000001
1000000000000000000000000000000000000300000000000000002000000000000001
1000000000200000000000000000000000000000000000000000000022000000000001
1000000300000000000011111111000000000000000000000000000002200000000001
1000000000000000011111000111111100000000000000000000000000000000000001
1000000000000000111000000000011110000200000000020000000000000000000001
1000000000000001100000000000000110000000000000002000000000000000000001
1000000000000011000000000000000010000000000000000000200000000300000001
1000000000000010000000000000000000000000000000000000000000000000030001
1000000000000010000020003000000000000000000000000000000000000000000001
1000000000000010000020000000002000000001110003000000011000000000000001
1000000000000110000000000000000000000001110000000000011000000200000001
1000020000000111000000000020000000000111111100000011111110000020000001
1000000000000110000000200000000000000111111100000011111110000000000001
1000000000000111000000000000000000000001110000000000011000000000000001
1000000000000111000003000000000000000001110000030000011000000000000001
1000300000000011100000000020000000000000000000000000000000000000000001
1000000003000011100000000000000001000000000000000000000000030000000001
1000000000000001100000000000000001000000000000000000000000000000000001
1000000000000000110000000003000001000000000000000200000000000000000001
1000000000000000011110000000000001000000020000000000000000000000000001
1000000020000000001111110000000111000000020000000000000000000000000001
1000000000000000000001111111111100000000000000000000000000002200000001
1000000000000000000000000111111000000000000000000000000000000000000001
1000000000000000000000000000000000000000000000000000000000000000000001
1000000000000000000000000000000000000000000000000000000000000000000001
1111111111111111111111111111111111111111111111111111111111111111111111
