1111111111111111111111111111111111111111111111111111111111111111111111
1000000000000000000000000000000000000000000000000000000000000000000001
1000000000000000000000000000000000000000000000000000000000000000000001
1000000000000000000000000000000000000000002000000000000000000000000001
1000000000000000000000000000000000000000000000000000000100000000000001
1000000000000000000000000000000000000000000000000000001100000000000001
1000000000000000000000000000000000000000000000000000011000000000000001
1000000000000000000000000000000000000000000000000000110000000000000001
1000000000000000000002000000000000000000000000000011100000000000000001
1000000000000000000000000000000000000000000000000100000000000000000001
1000000000000000000000000000000000000000000000010000000000000000000001
1000002000000000000000000000020000000000000010100000000000000000000001
1000000000000000000000000000000000000000001000000000000000000000000001
1000000000000000000000000000000000000001100000000000000000020000000001
1000000000000000000000000000000000010100000000000000000002220000000001
1000000000000003000000000000000020100000000000000000000000000000000001
1000000000000000000000000000001110000000000000000000000000000000000001
1000000000000000000000200000111000000000000000000000000000000000000001
1000000000000000000000000011100000000000000000000000000000000000000001
1000000000000000000000011100000000000000000000000000000000000000000001
1000000000000000000000000000000000000000000000000000000000000000000001
1000000000000000000000000000000000000000030000000200000000000000000001
1002000000000000000000000000000000000000000000000000000000000000000001
1000000000000000000300000000000000000000000000000000000000000000000001
1000000000002000000000000000200000000000000000000000000000000000000001
1000000000000000000000000000000000000000000000000000000000000000000001
1000000000000000000000000000000000000000000000000000000000000000000001
1000000000000000000000000000000000000000000000000000000000000000000001
1000000000000000000000000000000000000000000000000000000000000000000001
1111111111111111111111111111111111111111111111111111111111111111111111
