1111111111111111111111111111111111111111111111111111111111111111111111
1000000000000000000000000000001000000000000000000000000000000000000001
1000000000000000000000000000001000000000000000000000000000000000000001
1000002000000000000000000200001000000000000000000000000000000000000001
1000000000000000000000000000000100000000100000002000000000000000000001
1000000000001000000000000000001000000000000000000000000000000000000001
1000000000000000000000000000000000000000000000000000000000010000000001
1000000000000030000000000000000000000000000000000300000000000000000001
1000200000000000000000000100000000000200000000000000000000000000000001
1000000000000000000000000000010000000000000000000000000000000000000001
1000000000000000000000000000000001000000000000000000001000000000000001
1000000000000000000000000000000000100000000000000000000000000200000001
1000000000000000000001000000200000000000000000000000000000000000000001
1000001000000010000000000000000000000000000002000000000000000000000001
1000000000000000000000000000000000000010000000000000000000000000000001
1000000000000000000200000000000000000000000000000000000000002000000001
1000000000000000000000000000010000000000000000200000000100000000000001
1000000000000000000000000000003000000000000030000000000000000000000001
1000000000000000000000003000000000000010000000000000000000000000000001
1000000000300001000000000000000000000000000000000000000000002000000001
1000000000000000000000000000000000000000000000000000000000000000000001
1000000000000000000000000000000000000000000000000000000000000000020001
1000000000000000000000000000200000003000000000000000000010000000000001
1000000000000000010000000000000000000000000001111000000000000000000001
1200000000000000000000020000000000000000000000000000000000003000000001
1000000000000000000000000000000100000000001000000000000000000000000001
1000000020000000000000000000000000000002000000000010000000000000000001
1003000000000000000000000000000000000000000000000000000000000020000001
1000000000000000000000000000000000000000000000000000000000000000000001
1111111111111111111111111111111111111111111111111111111111111111111111
