1111111111111111111111111111111111111111111111111111111111111111111111
1222222222222222222222222222222222222222222222222222222222222222222221
1222222222222222222222222222222222222222222222222222222222222222222221
1000000000000022222222222222222222222222222222222222222222222222222221
1000000000000022222222222222222222222222222222222222222222222222222221
1222222222200022222222222222222222222222222222222222222222222222222221
1222222222200022222222222222222222222222222222222222222222222222222221
1222222222200022222222222222222222222222222222222222222222222222222221
1222222222200022222222222222222222222222222222222222222222222222222221
1222222222200000000000000222222222222222222222222222222222222222222221
1222222222200000000000000000000000000000222222222222222222222222222221
1222222222222222222222000000000000000000222222222222222222222222222221
1222222222222222222222222222222222222000222222222222222222222222222221
1222222222222222222222222222222222222000222222222222222222222222222221
1222222222222222222222222222222222222000222222222222222222222222222221
1222222222222222222222222222222222222000000000000002222222222222222221
1222222222222222222222222222222222222000000000000002222222222222222221
1222222222222222222222222222222222222222222222220002222222222222222221
1222222222222222222222222222222222222222222222220002222222222222222221
1222222222222222222222222222222222222222222222220002222222222222222221
1222222222222222222222222222222222222222222222220002222222222222222221
1222222222222222222222222222222222222222222222220002222222222222222221
1222222222222222222222222222222222222222222222220000000000000222222221
1222222222222222222222222222222222222222222222220000000000000222222221
1222222222222222222222222222222222222222222222222222222222000222222221
1222222222222222222222222222222222222222222222222222222222000222222221
1222222222222222222222222222222222222222222222222222222222000222222221
1222222222222222222222222222222222222222222222222222222222000000000001
1222222222222222222222222222222222222222222222222222222222000000000001
1111111111111111111111111111111111111111111111111111111111111111111111
