1111111111111111111111111111111111111111111111111111111111111111111111
1000000000001000100001000000000000001000000001000000000000000000000001
1000000000000000010001000000000000000000000000000000000000000000000001
1000000000001100100000000000000001000010000010000000000000000000000001
1000000000000000000000100000000000000000000000000100000000000000000001
1000000000000000000000000000000010000000000000110001110000000000000001
1000000000000001100000010000000000000000100100000000000000000000000001
1000000000000010000000100000000100001000100000000000000000000000000001
1000000000000000100000000000000001000000100010100110000000000000000001
1000000000000000100000100000101000000100000000010000100100000000000001
1000000000000001100010100011010010100000000100000000000001000000010001
1000000011011101101101100010001000000000000000100000000000000000011001
1000000100000000000011111100010001001000000001010010000000000000000001
1000001000000000001000000011110100000000000001000100000110000100010001
1000010000000000000000001010100000000000000000111000010010000100000101
1000010000000000001000000100000000000000000000010001010000000000000001
1000010000000000000000000000100000000000000100000110000000001100000001
1000010000000000000101001000100000000000000000000000000000110000100001
1000000000000000000100010000010000000000000000100001000010000000000001
1000001000000000000000000000000100000000000100100011000001000000000001
1000000000000000000001000000000001100100000010111000000000000000000001
1000000100000000000000000000000000001010101000100001000100000000100001
1000000001000000000100000100000010001000010000010000000000000000000001
1000000000101000001000000111100001000001100101000001000000000000000001
1000000000000111100000000000000000100001010000000000000000000001000001
1000000000000000000000000000000000000001100000000000000000000100000001
1000000000000000000000000000000000000000000010010100000000010001000001
1000000000000000000000000000000000010001000000000000000000000011000001
1000000000000000000000000000000000110000000000000100000000000000000001
1111111111111111111111111111111111111111111111111111111111111111111111
