1111111111111111111111111111111111111111111111111111111111111111111111
1000000000000000000000000000000000000000000000000000000000000000000001
1000000000000000000000000000000111111111110000000000000000000000000001
1000000000000000000000000111111100000000001000000000000000000000000001
1000000000000000000001111000000000000000000100000000000000000000000001
1000000000000000000110000000000111000000000100000100000000000000000001
1000000000000000111000000001111121100000000100001000000000000000000001
1000000000000011000000001110000000100000000100010000000000000000000001
1000000000001100000000110000000000100000001100100000000000000000000001
1000000000001000000011000000000001100000011001000000000000000000000001
1000000000010000000100000000000110000000110001000000000000000000000001
1000000000100000001000000000011100000001100100000000000000000000000001
1000000000100000110000000011110000001110001000000000000000000000000001
1000000000100001100010011110000000110000110000000000000000000000000001
1000000000100001000011110000000011000000100000000000000000000000000001
1000000000100001000000000000011100000011000000000000000000000000000001
1000000000100001000000000011100000000100000000000000000000000000000001
1000000000110001000000011100000000001000000000000000000000000000000001
1000000000010001111111100000000000010000000000000000000000000000000001
1000000000001000000000000000000001100000000000000000000000000000000001
1000000000001110000000000000001110000000000000000000000000000000000001
1000000000000001111000000111110000000000000000000000000000000000000001
1000000000000000000111111000000000000000000000000000000000000000000001
1000000000000000000000000000000000000000000000000000000000000000000001
1000000000000000000000000000000000000000000000000000000000000000000001
1000000000000000000000000000000000000000000000000000000000000000000001
1000000000000000000000000000000000000000000000000000000000000000000001
1000000000000000000000000000000000000000000000000000000000000000000001
1000000000000000000000000000000000000000000000000000000000000000000001
1111111111111111111111111111111111111111111111111111111111111111111111
