1111111111111111111111111111111111111111111111111111111111111111111111
1000000000000000000000000000000000000000000000000000000000000000000001
1000000000000000000000000000000000000000000000000000000000000000000001
1000000000000000000000000000000000000000000000000000000000000000000001
1000000000000000000000000000000000000000000000000000000000000000000001
1000000000000000000000000000000000000000000000000000000000000000000001
1000000000000000000000000000000000000000000000000000000000000000000001
1000000000000000000000000000000000000000000000000000000000000000000001
1000000000000000000000000000000000000000000000000000000000000000000001
1000000000000000000000000000000000000000000000000000000000000000000001
1000000000000000000000000000000000000000000000000000000000000000000001
1000000000000000000000000000000000000001000000000000000000000000000001
1000000000000000000000000000000000000010000000000000000000000000000001
1000000000000000101001010010000000001001000100000000000000000000000001
1000000000011010000000000000101111101100000000000000000000000000000001
1000000001100000000000000000000000100000000000000000000000000000000001
1000000010000000000000000000000010000000000000000000000000000000000001
1000000010000000000000000000000000000000000000000000000000000000000001
1000000001000000000000000000100000000000000000000000000000000000000001
1000000001000000000000000010000000000000000000000000000000000000000001
1000000000110000000000001000000000000000000000000000000000000000000001
1000000000001011111011000000000000000000000000000000000000000000000001
1000000000000000000000000000000000000000000000000000000000000000000001
1000000000000000000000000000000000000000000000000000000000000000000001
1000000000000000000000000000000000000000000000000000000000000000000001
1000000000000000000000000000000000000000000000000000000000000000000001
1000000000000000000000000000000000000000000000000000000000000000000001
1000000000000000000000000000000000000000000000000000000000000000000001
1000000000000000000000000000000000000000000000000000000000000000000001
1111111111111111111111111111111111111111111111111111111111111111111111
