1111111111111111111111111111111111111111111111111111111111111111111111
1000000000000000000000000000000000000000000000000000000000000000000001
1000000000000000000000000000000000000000000000000000000000000000000001
1000000000000000000000000000011101110111011011111111000000000000000001
1000000000000000000000000111100000000000000000000000110000000000000001
1000000000000000000000111000000000000000000000000000001000000000000001
1000000000000000000111000000000000000000000000000000001000000000000001
1000000000000000001100000000000000000000000000000000001000000000000001
1000000000000000011000000000000000000000000000000000001000000000000001
1000000000000000110000000000000000000000000000000000001000000000000001
1000000000000000100000000000000000000000000100000000010000000000000001
1000000000000000100000000000000000000000000100000000010000000000000001
1000000000000000100000000000000000000000000100000000010000000000000001
1000000000000000100000000000000000000000001000000000110000000000000001
1000000000000000010000000000000000000000010000000000100000000000000001
1000000000000000010000000000000000000001100000000001100000000000000001
1000000000000000001000000000000000000011000000000011000000000000000001
1000000000000000000100000000000000000110000000000010000000000000000001
1000000000000000000010000000000000011100000000000100000000000000000001
1000000000000000000001111000001111110000000000001000000000000000000001
1000000000000000000000001111110000000000000000010000000000000000000001
1000000000001000000000000000000000000000000000110000000000000000000001
1000000000001100000000000000000000000000000000100000000000000000000001
1000000000000011000000000000000000000000000001000000000000000000000001
1000000000000000111000000000000000000000000010000000000000000000000001
1000000000000000001111000000000000000001011100000000000000000000000001
1000000000000000000001111000000000101110000000000000000000000000000001
1000000000000000000000000111111111000000000000000000000000000000000001
1000000000000000000000000000000000000000000000000000000000000000000001
1111111111111111111111111111111111111111111111111111111111111111111111
