1111111111111111111111111111111111111111111111111111111111111111111111
1000000000000000000000000000000000000000000000000000000000000000000001
1000000000000000000000000000000000000000000000000000000000000000000001
1000000000000000000000000000000000000000000000000000000000000000000001
1000000000000000000000000000000000000000000000000000000000000000000001
1000000000000000000000000000000000000000000000000000000000000000000001
1000000000000000000000000000000000000000000000000000000000000000000001
1000000101010010010010100100100000000000000000000000000000000000000001
1000011000000000000000000000000100000000000000000000000000000000000001
1000100000000000000000000000000000101000000000000000000000000000000001
1001000000000000000000000000000000000101000000000000000000000000000001
1001000000000000000000001100000000000000100000000000000000000000000001
1010000000000000000000001000000000000000010000000000000000000000000001
1010000000000000000000000000000000000000001000000000000000000000000001
1010000000000000000000001000000000000000001000000000000000000000000001
1010000000000000000000001000000000000000000100000000000000000000000001
1010000000000000000000000000000000000000000010000000000000000000000001
1010000000000000000000001000000000000000000010000000000000000000000001
1001000000000000000000000000000000000000000110000000000000000000000001
1001000000000000000000000100000000000000000100000000000000000000000001
1000100000000000000000000011000000000000001000000000000000000000001001
1000010000000000000000000000101000000000110000000000000000001000000001
1000001100000000000000000000000110111101000000000000000000000000000001
1000000010000000000000000000000000000000000000000000001000000000000001
1000000001011000000000000000000000000000000000000010000000000000000001
1000000000000010110010000000000000000000000010100000000000000000000001
1000000000000000000000010010000100010010010000000000000000000000000001
1000000000000000000000000000000000000000000000000000000000000000000001
1000000000000000000000000000000000000000000000000000000000000000000001
1111111111111111111111111111111111111111111111111111111111111111111111
