1111111111111111111111111111111111111111111111111111111111111111111111
1000000000000000000000000000000000000000000000000000000000000000000001
1000000000000000000000000000000000000000000000000000000000000000000001
1000000000000000000000000000000000000000000000000000000000000000000001
1000000000000000000000000000000000000002002002000000000000000000000001
1000000000000000000000001000010000200000000000220000000000000000000001
1000000000000000000000000000002000000010000000020000000000000000000001
1000000000000000000100000000000000000000110000020000000000000000000001
1000000000000000100000000002010000010001001010000000000000000000000001
1000000000000000000111001000000000000000000100020000000000000000000001
1000000000000000100011102000000002200000000000000010000000000000000001
1000000000001010001100000000200000020000000000200000100000000000000001
1000000000000000000000200000000000020000000002000000010000000000000001
1000000000000000000001002000000000020000001001000011010000000000000001
1000000100000100200000000000000000200001000200000000011000000000000001
1000000000000000000100002220001020221202100000000000000100000000000001
1000000000002000000000010200002000200020220000000000010100000000000001
1001000000000010001000020022020000222000100202000000100100000000000021
1000000000200000001000200000000001000010000000000000001000000000000001
1000000000000001110002000000000000000000000000200100100000000000000201
1000000002000001120200000000000001000000000000020000000000000000000001
1000000000000020000000000000000011000200000020020102000000200002000201
1000000002202010000000000000000202010101010100000000000000000000002001
1000000000000001100000001000002000000100000000020000000000000000000221
1000000000000000001000010000012000000000000000020000000000000000000001
1000000000000000010000000000002200000000000002000000000000000000000001
1000000000010000000000000000000020000000002020000000000000000000000001
1000001000000000000000000000000000200200200000000000000000000000000001
1101000000000000000000000000000000000000000000000000000000000000000001
1111111111111111111111111111111111111111111111111111111111111111111111
