1111111111111111111111111111111111111111111111111111111111111111111111
1000000000000000000000000000000000000000000000000000000000000000000001
1000000000000000000000000000000000000000000000000200000000000000000001
1000000000000000000200000000000000003300000000002000000000000000000001
1000000000000000000200000000000333330000000000020000000000000000000001
1000000000000000000200000000033000000000000000200000000000000000000001
1000000000000000000200000000000000000000000000200000000000000000000001
1000000000000000000200000000000000000000000002200000000000000000000001
1000000000000000000200000000000000000100000002000000000000000000000001
1000000000000000000200000000000000000100000002000000000000000000000001
1000000000000000000200000000000000001000000022000000000000000000000001
1000000000000000000200000000000000001000000020000000000000000000000001
1000000000000000000200000000000000010000000220000000000000000000000001
1000000000000000000220000000000000010000000200000000000000000000000001
1000000000000000000020000000000000110000002000000000000000000000000001
1000000000000000000020000000000000100000002000000000000000000000000001
1000000000000000000000000000000000100000002000000000000000000000000001
1000000000000000000000000000000000100000000000000000000000000000000001
1000000000000000000000000000000001100000000000000000000000000000000001
1000000000000000000000000000000001000000000000000000000000000000000001
1000000000000000000000000000000000000000000000000000000000000000000001
1000000000000000000000000000000000000000000000000000000000000000000001
1000000000000000000000000000000000000000000000000000000000000000000001
1000000000000000000000000000000000000000000000000000000000000000000001
1000000000000000000000000000000000000000000000000000000000000000000001
1000000000000000000000000000000000000000000000000000000000000000000001
1000000000000000000000000000000000000000000000000000000000000000000001
1000000000000000000000000000000000000000000000000000000000000000000001
1000000000000000000000000000000000000000000000000000000000000000000001
1111111111111111111111111111111111111111111111111111111111111111111111
