1111111111111111111111111111111111111111111111111111111111111111111111
1000000000000000000000000000000000000000000000000000000000000000000001
1000000000000000000000000000000101100000000000000000000000000000000001
1000000000000000000000000000010000010000000000000000000000000000000001
1000000000000000000000000001000000010000000000000000000000000000000001
1000000000000000000000000000000000000000000000000100000000000000000001
1000000000000000000000200220000000000000000000001010000000000000000001
1000000000000020202200000012000000010000000000000000000000000000000001
1000000000000000000200000002000000000000000000001001000000000000000001
1000000020020000002000000020020220000000000000000000000000000000000001
1000000020000000000002000200000020101110000000000100000000000000002001
1020000200000000000000000000000200000010000222000011000000000000000001
1000000000000000200020000000002000001000200000200001000000000000000001
1000000200000002000011000100000000000010000000200000101000101000000001
1000000200000022000000000002000010000020000000000010000010000020000001
1000000020000002000100020000000000001100000020000000000000000000000001
1020000000200200202000000010000000000200002000000000000000000000000001
1000000000000000001000000000000000001000000000000000000020000000000001
1000000000000000002000000001010000002120000000001000000000000000000001
1000000000000000001000200002100002012010000000000002000000000000000001
1000000000000000001000000010011101000202000001000000000000000000000001
1000000000000000001000001000000000000001120102000000000000000000000001
1000000000000000000110100000000000000000000000000000000000000000000001
1000000000000000000000000000000000000000000000000000000000000000000001
1000000000000000000000000000000000000000000000000000000000000000000001
1000000000000000000000000000000000000000000000000000000000000000000001
1000000000000000000000000000000000000000000000000000000000000000000001
1000000000000000000000000000000000000000000000000000000000000000000001
1000000000000000000000000000000000000000000000000000000000000000000001
1111111111111111111111111111111111111111111111111111111111111111111111
