1111111111111111111111111111111111111111111111111111111111111111111111
1000000000000000000000000000000000000000000000000000000000000000000001
1000020000000000000000000000000000000000000000000000000000000000000001
1000000000000000000000000000000000000000000000000000000000000000000001
1000000000000000000000000000000000000000000000000000000000000000000001
1000000000000000000000000000000000000000000000000000000000000000000001
1000000000000000000000000000000000000000222000000000000000000000000001
1000000000000000000000000000000000000000000110000000000000000000000001
1000000000000000000000000000000000000000011100000000000000000000000001
1000000000000000000000002000000000000000100000000000000000000000000001
1000000000000000000000000000000000000101000000000000000000000000000001
1000000000000000000000000000000000011000000000000000000000000000000001
1000000000000000000000000000000001100000000000000000000000000000000001
1000000000000000000000000000000011000000000000000000000000000000000001
1000000000000000000000000000001100000000000000000000000000000000000001
1000000000000000000000000000011000000000000000000000000000000000000001
1000000000000010000000000011100000000000000000000000000000000000000001
1000000000000001111111111110000000000000000000000000000000000000000001
1000000000000000000000000000000000000000000000000000000000000000000001
1000000000000000000000000000000000000000000000000000000000000000000001
1000000000000000000000000000000000000000000000000000000000000000000001
1000000000000000000000000000000000000000000000000000000000000000000001
1000000000000000000000000000000000000000000000000000000000000000000001
1000000000000000000000000000000000000000000000000000000000000000000001
1000000000000000000000000000000000000000000000000000000000000000000001
1000000000000000000000000000000000000000000000000000000000000000000001
1000000000000000000000000000000000000000000000000000000000000000000001
1000000000000000000000000000000000000000000000000000000000000000000001
1000000000000000000000000000000000000000000000000000000000000000000001
1111111111111111111111111111111111111111111111111111111111111111111111
