1111111111111111111111111111111111111111111111111111111111111111111111
1000000000000000000000000000000000000000000000000000000000000000000001
1000000000000000000000000000000000000000000000000000000000000000000001
1000000000000000000000000300000000000000000000000000000000000001030101
1000103100000000000000000000000000000000000030000000000000000000020001
1000302300000000000000000000000000000000000000000000000000000001030101
1000103100000000000000000000000030000000000000000000000000000000000001
1000000000000000000030000001000000000000000000000000000000000000000001
1000000000000000000000000010000000000000000000000000000000000000000001
1000000000010000000000000100000000000000000200000000000300000000000001
1000000000010000000000011000000000000000000000000000000000000000000001
1000000000000000000000000000000000000000000000000000000000000000000001
1000000000000000003000000000000000000000000000000000000000000000000001
1000000000010000000000000000000000000003000000000000000000000000000001
1000000000000000000000000000000000000000000000000000000000000000000001
1000000000000000000000000000000000000000000000000000000000000000000001
1000000000000000000000000000000000000000000000000020000000030000000001
1000030000010000010010010001000010000100301000000000000000000000000001
1000000000000000000000000000000000000000000000000000000000000000000001
1000000000000000000000000000000000000000000000000000000000000000000001
1000000000010000000000000030000000000000000000000000000000000000000001
1000000000000000000000000000000000000000000000000000000000000000000001
1000000000000000000300000000000000000000000000000000000000000000000001
1000000000000000000000000000000000000000000000000000030000000000000001
1000000000000000000000000000000020000000000300000000000000000010010001
1111210101001000000000000000000000000000000000000000000000000000230001
1000000000000000000000003000000000000300000000000000000000000010010001
1000000000000000000000000000000000000000000000000000000000000000000001
1000000000000000000000000000000000000000000000000000000000000000000001
1111111111111111111111111111111111111111111111111111111111111111111111
