1111111111111111111111111111111111111111111111111111111111111111111111
1000000000000000000000000000000000000000000000000000000000000000000001
1000000000000000000000000000000000000000000000000000000000000000000001
1000000000000000000000000000000000000300000000000000000000000000000001
1000000000000000000000000000000000000100000000000000000000000000000001
1000000000022022022202220222000000000100000000000000000000000000000001
1000000000020202020202220220000000000111111100000000000000000000000001
1000000000020002022202000222000000000113333110000000000000000000000001
1000000000000000000000000000000000000111333311000000000000000000000001
1000000000000000000000000000000000000111113331000000000000000000000001
1000000000000000000000000000000000000111001331100000000000000000000001
1000000000000000000000000000000000000111000131100000000000000000000001
1000000000000000000000000000000000000111011131100000000000000000000001
1000000000000000020000000000000000000111113331100000000000000000000001
1000000000000011111111000000000000000111333111000000000000020000000001
1000000000000011111111100000000000000111111100000000000001111100000001
1000000000000011131311100000000000000111000000000000000011111100000001
1000000000000011131311110000002000000110002000200020001111111100000001
1000000000000001131311111111111111111111111111111111111111111000000001
1000000000000000111111111311111311111311113111131111111111111000000001
1000000000000000011111111111111111111111111111111111111111100000000001
1000000000000000000011111111111111111111111111111111111100000000000001
1000000000000000000000000000000000000000000000000000000000000000000001
1000000000222222000002222222000000000000000000000000000000000000000001
1000000000200002222222000002220022222222222000000000022222222000000001
1000000000000000022000000000020220000000002202220022200000002000000001
1000000000000000000000000000000000000000000022022000000000000000000001
1000000000000000000000000000000000000000000000000000000000000000000001
1000000000000000000000000000000000000000000000000000000000000000000001
1111111111111111111111111111111111111111111111111111111111111111111111
